   aabbcy --> abbacy
   abey --> abey
   aabilnot --> obtainal
   abdgilnnouy --> aboundingly
   abccdeennos --> abscondence
   aabciinorssttt --> abstractionist
   aaacen --> acaena
   aaclor --> acarol
   acceeilssvy --> accessively
   acchilmopst --> accomplisht
   accersu --> accuser
   aaccefiiinott --> acetification
   aceeilrtyz --> acetylizer
   aceehr --> achree
   accdiiot --> acidotic
   aacmo --> macao
   aacdinr --> craniad
   acimnoor --> acromion
   acefiirt --> artifice
   aacilmnoostt --> actinostomal
   aaccelmntuuu --> unaccumulate
   aadnw --> adawn
   aadeel --> adelea
   aademnoost --> adenostoma
   adiilopssy --> adipolysis
   aadeiimnrstt --> administrate
   aadeinooprt --> adoperation
   abdenorst --> adsorbent
   adeeemnorstuv --> adventuresome
   adeehiilps --> aedileship
   aceir --> erica
   aaaceilnortu --> aeronautical
   aabeosttu --> aetobatus
   aceffiiltv --> afflictive
   aaafiknrs --> afrikaans
   aefmorstt --> aftermost
   aaeegmt --> agamete
   acegny --> agency
   aegilly --> agilely
   aadgiinno --> anangioid
   aagmoryz --> agromyza
   aghnruy --> hungary
   afiilor --> airfoil
   aagju --> jagua
   aaaceeilnrt --> alacreatine
   abeilnrt --> albertin
   aabilnnntu --> albutannin
   aaacilnnory --> alcyonarian
   aelm --> mela
   aacdeegil --> algaecide
   aglosu --> algous
   aaceilmossu --> alismaceous
   aeekllny --> alkylene
   aeillnor --> allerion
   aaghllopr --> allograph
   aablllowy --> allowably
   aadeilmorv --> almoravide
   alow --> lowa
   aaaeglrt --> altarage
   aaciillrt --> altricial
   aellmoootvy --> alveolotomy
   aahiimrrstt --> amarthritis
   aabceeilmnv --> ambivalence
   adeem --> medea
   aemorstu --> ametrous
   aacciimnoopr --> aminocaproic
   aaeiimmnnoortt --> ammonionitrate
   ahimmoprs --> amorphism
   aaaacehimppr --> amphicarpaea
   aabcehiimnps --> amphisbaenic
   aadellmptu --> ampullated
   adhillmoorssyyy --> amylohydrolysis
   aachinnorst --> anachronist
   aaglnnopty --> anaglypton
   aacilnsty --> analytics
   aaceinnp --> anapneic
   aaeehimntz --> anathemize
   aceiimnnst --> ancientism
   aacdehlmnopru --> androcephalum
   aceeimmnort --> anemometric
   aacegiln --> angelica
   aaacgiilnoprty --> angioparalytic
   aacegmnru --> angraecum
   acein --> eniac
   aadinnorssu --> anisandrous
   aaint --> tania
   aeennrux --> annexure
   adnnoo --> anodon
   achimnors --> harmonics
   aeellnrssswy --> answerlessly
   acenorttu --> antecourt
   aeeinnorrsst --> anteriorness
   aehilnott --> antholite
   aabdehiinrt --> anthribidae
   aachinnortx --> anthroxanic
   aabciilnstt --> antiblastic
   aceimmnnott --> anticomment
   adgiimnnptu --> antidumping
   aginnnoot --> antigonon
   acgiilnot --> antilogic
   aaaeiinnrrttv --> antinarrative
   aaaceiiillnprsttty --> antiperistatically
   aciiinprrttu --> antipruritic
   acfilnoorsstuu --> antiscrofulous
   aacdiiilmnnssty --> antisyndicalism
   aiinrstuv --> antivirus
   ahnowy --> anyhow
   aaekp --> apeak
   aadghhiooppsu --> aphidophagous
   aiip --> apii
   aachop --> apocha
   aiiklnoopty --> apolytikion
   aehiloppsst --> apostleship
   aaabeeelnppsss --> appeasableness
   aaeilppsuv --> applausive
   aeehinnopprs --> apprehension
   aacioprt --> aproctia
   aaciqtu --> aquatic
   aachiinrst --> arachnitis
   aabcinr --> carabin
   aaccehhiilort --> archaeolithic
   aacccceehiilrsst --> archecclesiastic
   aaacghilrrstu --> archigastrula
   achnor --> rancho
   accemnorrtu --> arcocentrum
   aaeeeeginrrtv --> aregenerative
   aeginnort --> argention
   aaciiinrst --> arianistic
   airsu --> asuri
   abenr --> reban
   aehknooorrstu --> arrhenotokous
   aeehlmnoors --> arsenohemol
   aeiioorrssstt --> arteriostosis
   achooprrsty --> arthroscopy
   aaghooprstu --> artophagous
   acdens --> ascend
   aaclsu --> causal
   aais --> asia
   aaeginoprst --> aspergation
   aalprsw --> asprawl
   aaeinorssssy --> assessionary
   aeorrsst --> reassort
   adelnoooprssstuy --> asterospondylous
   aeginrrst --> astringer
   ailrsw --> aswirl
   aacceeilttt --> atelectatic
   addhoty --> athodyd
   allot --> atoll
   aachort --> atrocha
   aeeintttv --> tentative
   aberuy --> aubrey
   ahhuuu --> auhuhu
   aaceillmooprrtuu --> auriculotemporal
   aacehiloprssttuu --> australopithecus
   aaaiiilmnoossttu --> autoassimilation
   aaadeginortu --> autodrainage
   aglootuy --> autology
   aeooprtu --> autopore
   amoottuy --> autotomy
   aaacehlnv --> avalanche
   aaiirtvx --> aviatrix
   aaekw --> awake
   acefhtx --> axfetch
   aaaacdhrtz --> azadrachta
   aeeinnorvz --> azovernine
   abbehips --> babeship
   aabccchil --> bacchical
   aabcddehkn --> backhanded
   aabcdkmnoosw --> backwoodsman
   abcilu --> baculi
   abeghil --> bagheli
   abhiinrs --> bisharin
   aaabglny --> bangalay
   abeklr --> barkle
   ablmnoy --> balmony
   abbemtu --> bambute
   abddhintw --> bandwidth
   abeeeginnqrtu --> banqueteering
   aabbeinorrsssu --> barbariousness
   abfhirs --> barfish
   aabmnnr --> barnman
   aabegiklmnrr --> barrelmaking
   aaabils --> basalia
   aaabdgillnrsu --> basiglandular
   aabnss --> bassan
   abchhiilott --> batholithic
   aabbeelrtt --> batterable
   aably --> bayal
   abefklu --> beakful
   aabbeelt --> beatable
   abceerv --> becarve
   bde --> deb
   abdelr --> blader
   beeeiln --> beeline
   abdeefhnor --> beforehand
   aabceeegino --> begoniaceae
   abbdehnsu --> behusband
   abdeglr --> belgrad
   beeiklllosw --> bellowslike
   abeejmsty --> bemajesty
   abcdeeiilnnot --> benedictional
   beeehns --> shebeen
   bccegillnooyz --> benzoglycolic
   beillp --> bepill
   beglrty --> bergylt
   abeillry --> reliably
   bcehimrs --> besmirch
   bcekost --> bestock
   beelotw --> betowel
   beimotv --> bevomit
   aabhinv --> bhavani
   bbgiilnooy --> bibliogony
   bceikr --> bicker
   bein --> bien
   bgiotty --> bigotty
   bhiilnot --> bilithon
   abeiillmmst --> bimetallism
   abcdeeilntu --> binucleated
   abghioopsu --> biophagous
   abchiips --> biphasic
   abdeehiknr --> birkenhead
   abcchiiiisst --> bisischiatic
   beinostt --> bitstone
   aabcklmoor --> blackamoor
   abdddeeelrw --> bladderweed
   abeehlmps --> blaspheme
   ablortw --> blawort
   aabeghilnnorr --> blennorrhagia
   bdgiillnny --> blindingly
   bchikllosy --> blockishly
   bgillmnooy --> bloomingly
   abbdeelru --> bluebeard
   bdelrru --> blurred
   aabilott --> boattail
   bcdkoo --> bodock
   abeeiklmorr --> boilermaker
   belort --> bolter
   abdemnnor --> bonderman
   bdooy --> boody
   bmooy --> boomy
   aborsssu --> borassus
   bghhiooprsu --> boroughship
   bcdehloty --> botchedly
   begou --> bouge
   aabdioruv --> bouvardia
   abcorx --> boxcar
   aabcdghiinoor --> brachioganoid
   abceknr --> bracken
   aaabchhimrr --> brahmachari
   abcehillnnor --> branchellion
   abeilorstt --> strobilate
   aabdeeenrrr --> breadearner
   bceeknr --> brecken
   beeiinorrrsstv --> brevirostrines
   bdeegiiklr --> bridgelike
   binr --> brin
   abdenorss --> broadness
   behlmorty --> bromethyl
   abccehnnooorrsuv --> bronchocavernous
   beikkloor --> brooklike
   borstw --> browst
   belrtuy --> butlery
   aabcehlpu --> bucephala
   bddelru --> buddler
   bdeilru --> rebuild
   bdellouz --> bulldoze
   bccklmou --> bumclock
   bdentu --> bunted
   abegilrruz --> burglarize
   beorrruw --> burrower
   bdeiknsu --> buskined
   abemnrttu --> butterman
   bdoruwzz --> buzzword
   aabcck --> caback
   aaacchz --> cachaza
   accit --> cacti
   aacce --> caeca
   aaccdeilr --> cailcedra
   aaaceilmnt --> catamenial
   abcchiloopsu --> calciphobous
   aabcilorrt --> calibrator
   aachiillmnptu --> callithumpian
   aaclprt --> caltrap
   aacdeillmot --> camaldolite
   acckmmoy --> cammocky
   acmnoopstu --> camponotus
   acceimnrs --> cancerism
   acehnopr --> chaperno
   aaclnnu --> cannula
   acelntt --> cantlet
   aacchip --> capicha
   aacpr --> capra
   aceinopssstu --> captiousness
   aacprsu --> carapus
   abceinorz --> carbonize
   acderr --> carder
   aacdegiilopr --> cardioplegia
   acgor --> cargo
   acelmr --> mercal
   aceorsu --> euscaro
   acrr --> carr
   aacrtwy --> cartway
   acceis --> caseic
   aceiopss --> cassiope
   aceeillstw --> caswellite
   aacgiimntt --> catamiting
   acceehisst --> catechesis
   aachty --> cathay
   aacinnot --> catonian
   acelsu --> clause
   acinostu --> cautions
   aceinr --> cearin
   abceelorrty --> celebratory
   aceeilllllptuy --> cellulipetally
   aceenorst --> censorate
   acellnrty --> centrally
   cep --> cep
   aaccehlooprrtt --> cephalotractor
   acceinrsu --> ceraunics
   abceeeilnoorrrss --> cerebrosensorial
   aceiiorrrt --> certiorari
   acdeeist --> desicate
   aaceefhirt --> chaetifera
   achl --> chal
   achills --> challis
   achimnop --> champion
   aacchilot --> chaotical
   aacchlory --> charcoaly
   aaceehmrrrstt --> chartermaster
   abcehorttx --> chatterbox
   bccehkkoo --> checkbook
   ceeehrsy --> cheesery
   acehiimrstt --> theatricism
   cccehkor --> chercock
   cdeehw --> chewed
   ceefhilss --> chiefless
   chilly --> chilly
   chiinn --> chinin
   chimorsy --> chiromys
   aacdhlmmnoosy --> chlamydomonas
   cfhilmooorrst --> chloroformist
   cehinox --> hexonic
   acehlor --> chorale
   cddehinoort --> chondrodite
   cddehor --> chorded
   cehlooorrstt --> chortosterol
   aachiiimnorssttx --> christianomastix
   chimmors --> chromism
   cchiinorty --> chronicity
   cehlrrsy --> chrysler
   achlnu --> nuchal
   aacghilmnoy --> chylangioma
   accdeiiln --> cinclidae
   accdhiiinno --> cinchonidia
   ciiinost --> cionitis
   cccceiilmrru --> circumcircle
   ccciiimnoprrstu --> circumscription
   aceist --> cistae
   ciilv --> civil
   acelmmr --> clammer
   aceklr --> reckla
   aaclv --> clava
   aceelnrss --> clearness
   cceghilnn --> clenching
   cfilty --> clifty
   cdiilno --> clinoid
   acelmno --> cloamen
   cdeefilosst --> closefisted
   cgilnorw --> clowring
   cdeiimmnu --> cnemidium
   acdeinotu --> coadunite
   aceeorrsst --> coasserter
   bciiost --> cobitis
   cccegosy --> coccyges
   bccdeeknory --> cockneybred
   acddeho --> codhead
   aacegiillmooy --> coeliomyalgia
   ceenoooprt --> coenotrope
   cefghiort --> cofighter
   cehno --> enoch
   cjoorru --> cojuror
   cehiiilnoprst --> colinephritis
   acegiillnoot --> collegiation
   cllooq --> colloq
   chlnooopy --> colophony
   celooprrt --> colporter
   acelmoosty --> comatosely
   acceilmot --> cometical
   abcdeelmmno --> commendable
   ceimmortt --> committer
   aceilmmottuvy --> commutatively
   aceeillmoptv --> compellative
   ceeelmnopsst --> completeness
   bciiilmoopssty --> compossibility
   aceimopttuv --> computative
   cceinnoopst --> conceptions
   cceeinnosss --> conciseness
   acdeemnnot --> condemnate
   ccdiilnottuy --> conductility
   aceefimnnorrtu --> conferruminate
   acdeflnot --> conflated
   ceegnnoorsu --> congenerous
   ccinos --> conics
   celnoy --> conley
   cegilnnoqruy --> conqueringly
   aceimnoorrstuv --> conservatorium
   cnoorst --> consort
   ccnorsttu --> construct
   aceinnorst --> sanctioner
   ceelnossstt --> contestless
   accinnoortt --> contraction
   aceennortv --> covenanter
   cnooruz --> conuzor
   ceinotvxy --> convexity
   ceoor --> cooer
   aceenop --> copaene
   cdeenoopprs --> coppernosed
   ceoqu --> coque
   aaacdeilnort --> cordaitalean
   ceeloorvv --> corevolve
   cceeiilnooorssu --> corneosiliceous
   aacghnooprr --> coronagraph
   cceeiorrtv --> corrective
   bceiloprrtu --> corruptible
   cilnory --> corylin
   acghmooprsy --> cosmography
   cefiinooorrst --> costoinferior
   ceelostt --> cotsetle
   cdlnooru --> couldron
   aacceennorrsstuu --> counterassurance
   aceeilnnoooprstttuux --> counterexpostulation
   acdeelnoprtu --> counterpaled
   cceeeilnnoorsttu --> counterselection
   ceeinnorssttuw --> counterwitness
   acmnortu --> turcoman
   cinoosuv --> covinous
   bccmooxy --> coxcomby
   acckry --> cracky
   acceimnorty --> cyanometric
   acrss --> scars
   aceilmry --> creamily
   ceeffkrstu --> creekstuff
   cceeilnprsuu --> crepusculine
   abceirrt --> cribrate
   cegiinrr --> criniger
   ccor --> croc
   cenoorr --> recroon
   aclort --> crotal
   ceorz --> croze
   cerrsuu --> surcrue
   cciprty --> cryptic
   aaceinoprtty --> cryptotaenia
   bbcehinsssu --> cubbishness
   cddeeuw --> cudweed
   acllrtuu --> cultural
   acnu --> unca
   acimmmnoopruu --> cuproammonium
   cceioprsuy --> curiescopy
   clrstuy --> curstly
   acepstu --> cuspate
   cmortuw --> cutworm
   aceehinnpy --> cyaphenine
   ccilnosty --> cyclonist
   cdeeilnrry --> cylinderer
   cdiinopy --> cynipoid
   ccehilmoopprsy --> cypselomorphic
   acmoossttuy --> cystomatous
   ceimmootty --> cytomitome
   accdiit --> dacitic
   aaddhinptu --> dadupanthi
   aaddiimry --> dairymaid
   adiimn --> damnii
   adeeglmnnt --> danglement
   adgor --> drago
   aaaddeisty --> dasyatidae
   adeginnnsstu --> dauntingness
   adekorrwy --> dayworker
   aaddeeims --> deamidase
   abdeefltu --> debateful
   accddeeenst --> decadescent
   acdert --> traced
   abcdeeeinorrt --> decerebration
   aacdeeilmnorsst --> declamatoriness
   aaccdeeennott --> deconcatenate
   acdemnu --> decuman
   deemopst --> deepmost
   ddeeefnrss --> defendress
   cdeeefiilnotz --> deflectionize
   adeeeeginrtv --> degenerative
   addeeghinnoorty --> dehydrogenation
   addeely --> delayed
   cdeeeilnnqu --> delinquence
   aabdeeegilmntz --> demagnetizable
   ddeeimmo --> demidome
   deilmssy --> demissly
   adelmnoorty --> demonolatry
   abddeenorst --> dendrobates
   adeeinottv --> detonative
   abdeilnnostt --> dentinoblast
   aadeeiinprstz --> departisanize
   adeilnooprt --> periodontal
   deeinoprsss --> depressions
   adeiinortv --> ordinative
   ademnooortz --> dermatozoon
   accddeeenns --> descendance
   abdeegilns --> designable
   demmoosty --> desmotomy
   deeflnooprssstu --> dessertspoonful
   abcdeeeltt --> detectable
   abdeeiilrst --> detribalise
   aadeklov --> devaloka
   ddeiov --> voided
   adeilrttxy --> dextrality
   abdeeeimortt --> diabetometer
   aadgillnoy --> diagonally
   aabcddikmno --> diamondback
   adeiirz --> diarize
   aadeimpz --> diazepam
   aacdehilmptu --> dichapetalum
   acdehinopt --> endopathic
   aacddhimr --> didrachma
   aadeffiinorrt --> diffarreation
   bdegiilsty --> digestibly
   bddhiiimrsy --> dihybridism
   adehiilnsttt --> dilettantish
   adeiimrt --> triamide
   deeiilnnoorttu --> dinitrotoluene
   deioprt --> pteroid
   dhiiimpssty --> diphysitism
   dilnooopz --> diplozoon
   cdeiiirttvy --> directivity
   aacdeffiimnrs --> disaffirmance
   adeinsttu --> disattune
   cdeiilps --> disciple
   cdgiimnoopss --> discomposing
   cdeiorrssu --> discourser
   addfiillnsuy --> disdainfully
   adeeilnssv --> disenslave
   ddegisstu --> disgusted
   deiiimmnnoprsst --> disimprisonment
   acddeeilnossst --> dislocatedness
   aadgiiinnoorstz --> disorganization
   adeeiilnoprssz --> dispersonalize
   adeiinooopprrstt --> disproportionate
   aacdfiiorssstty --> dissatisfactory
   acdeiiiosstv --> dissociative
   cdeiiilnsttvy --> distinctively
   bdiiinosstttuu --> disubstitution
   adghioprtty --> dittography
   dddeiinsv --> dividends
   dnr --> dnr
   cddeemnotu --> documented
   deeggilorst --> doggerelist
   deeelmnoosss --> dolesomeness
   bdemooor --> domeboro
   dgno --> gond
   dooyz --> doozy
   aabcdehiinorrst --> dorsibranchiate
   deort --> doter
   deghinossu --> doughiness
   cddenoruvw --> downcurved
   adeilmnoxy --> doxylamine
   adghinors --> dragonish
   aadghhimnprsstu --> draughtsmanship
   adeelmrss --> dreamless
   ddfiinrtw --> driftwind
   dgilnoor --> drooling
   ddirruy --> druidry
   deht --> dthe
   cdeilltuy --> ductilely
   cdfiluy --> dulcify
   cdfinuy --> duncify
   dnoopsuy --> duopsony
   bdeegnrsu --> dusenberg
   adersty --> dyaster
   abdilsuy --> dysbulia
   delossstyy --> dyssystole
   abehnorrt --> earthborn
   bbe --> ebb
   cceegilloosy --> ecclesiology
   accceeillt --> eclectical
   acceeeilnort --> ectocinereal
   acdeiosu --> edacious
   ddemnnoos --> edmondson
   ceefft --> effect
   eeffisuv --> effusive
   eggiloopstty --> egyptologist
   eiko --> okie
   aeilnot --> toenail
   bceegiillooorstt --> electrobiologist
   aceeegilmmnorstt --> electromagnetism
   accceeehiilnnortt --> electrotechnician
   acdeeehiilnpt --> elephanticide
   deklmo --> elkdom
   eeeehlrssw --> elsewheres
   aaceeiimnptv --> emancipative
   aabceeillmmt --> emblematical
   bceemmortyy --> embryectomy
   aaegiilmnort --> emigrational
   eemmprtu --> empetrum
   aeeilmtuv --> emulative
   aeemnr --> meaner
   acddeehinnoot --> enchodontidae
   cceiinnr --> encrinic
   deeimmns --> endemism
   adegmnoosu --> endogamous
   ddeenors --> endorsed
   adenooz --> endozoa
   aceefhinnrs --> enfranchise
   adeegilnr --> geraldine
   adeejnopr --> enjeopard
   beelnnor --> nonrebel
   eehllns --> enshell
   aeelnrt --> teneral
   aeenoortz --> enterozoa
   aelmnoot --> entoloma
   aegilnnpprty --> entrappingly
   egilnnvyy --> envyingly
   eeep --> epee
   abeilpst --> epiblast
   cdeeiimp --> epidemic
   aeegiinnpu --> epiguanine
   aehiilppsy --> epiphysial
   aeiipsstx --> epistaxis
   deehiilopt --> epitheloid
   eilpsu --> epulis
   abeiiilqru --> equilibria
   aaeillqruuvv --> equivalvular
   ceehiirstt --> erethistic
   abeioorrty --> eriobotrya
   eginrr --> ringer
   abcehilorrstty --> erythroblastic
   aceelors --> escarole
   aaegghmooooprssstty --> gastroesophagostomy
   aeeinnss --> essenian
   aeeisttv --> estivate
   eehlnty --> ethenyl
   aaceegghhilnooprt --> ethnogeographical
   aaehiluy --> euahlayi
   acdeeiilmortu --> eudiometrical
   cceeimtuy --> eumycetic
   aeenpu --> eupnea
   eeehnnooprsttu --> eusthenopteron
   aaceegiilllnstvy --> evangelistically
   aeeinrv --> evernia
   aegilnotuv --> evulgation
   aaeegrtuux --> exaugurate
   aceiorttx --> excitator
   ceenrrtux --> excurrent
   abceeeilrsx --> exercisable
   eehorrtx --> exhorter
   cceehioorrttxyy --> exoerythrocytic
   ceeiimorstx --> exotericism
   eeellprx --> expeller
   aelnptx --> explant
   beeiiilprsstxy --> expressibility
   aeeeimnoprttxy --> extemporaneity
   aeeiiprttvx --> extirpative
   aaceefiloorstux --> extrafoliaceous
   aaceimorsttx --> extrasomatic
   dentux --> extund
   aeeklsty --> eyestalk
   aceefilnss --> facileness
   adefr --> farde
   afgiiloorsty --> fairyologist
   aefllnossw --> fallowness
   adfmno --> fandom
   acfirst --> farcist
   aacefiinstv --> fascinative
   afhmot --> fathom
   aeflnuu --> faunule
   aefst --> feast
   acdefnortu --> fecundator
   ceefiilnossstu --> felicitousness
   aefilmn --> lifeman
   defirtw --> ferdwit
   acceefilorrt --> ferrocalcite
   aefilstv --> festival
   eefrw --> fewer
   bdfiior --> fibroid
   cfisu --> ficus
   adeeffiirrs --> fierasferid
   afgilo --> filago
   efillt --> fillet
   cefhinry --> finchery
   fiinty --> finity
   adeefinrrw --> firewarden
   afhimnosw --> fishwoman
   defitt --> fitted
   aeffflr --> flaffer
   aadefllmmtu --> flammulated
   aafhltt --> flathat
   adfloprx --> flaxdrop
   eflt --> flet
   afillnppty --> flippantly
   fglo --> golf
   efgiillmoru --> florilegium
   eflnoostw --> flowstone
   abefloortu --> fluoborate
   eeflrrstu --> flusterer
   cfhilnwy --> flywinch
   fghiosy --> fogyish
   cefilllos --> follicles
   abdfooort --> footboard
   afilmnoorsuu --> foraminulous
   aeefimnnoopprtt --> foreappointment
   effinor --> forefin
   eefimorrssst --> foremistress
   eefhoors --> foreshoe
   eeforrttu --> foreutter
   fgoorrw --> forgrow
   fgimnor --> forming
   efiorst --> forties
   efgilnorsty --> fosteringly
   fhlortuy --> fourthly
   aefr --> rafe
   aaefiknnr --> frankenia
   cefkr --> freck
   ceeefmnrst --> fremescent
   abdfiirrr --> friarbird
   efillrry --> frillery
   effgloorrw --> frogflower
   ffhiorsst --> frostfish
   efirrtuy --> fruitery
   ddeflru --> fuddler
   fklu --> fulk
   acfiilmnnostu --> functionalism
   eefikllnnu --> funnellike
   acfimnoorrsuu --> furocoumarins
   fgilsstuu --> fustilugs
   adeggty --> gadgety
   adegiilny --> gainyield
   aaegilnn --> galenian
   aacegilllo --> gallicolae
   aaegilnrvz --> galvanizer
   aaeeggmnt --> gametange
   aabdggnor --> gangboard
   acgino --> goniac
   aadglnrry --> garlandry
   aghsy --> gashy
   aaaginoorstt --> gastroatonia
   acegimnnooprstu --> gastropneumonic
   adeginssu --> gaudiness
   aagirty --> gayatri
   eegggry --> geggery
   eeglm --> gleem
   adeeegilnrz --> generalized
   eginsu --> genius
   aeglnopstyy --> genyoplasty
   aceegillmorty --> geometrically
   cegiooprt --> geotropic
   abceghimnoopr --> germanophobic
   eegnst --> gesten
   acfghorstt --> ghostcraft
   ddgiy --> giddy
   abegiilnrt --> gilbertian
   aggiilnv --> gingival
   dghiloor --> girlhood
   acgils --> glacis
   aeegilrst --> glaserite
   eeghillsy --> gleeishly
   bdgiloo --> globoid
   aagillorss --> glossarial
   eglorv --> grovel
   aeglltu --> gluteal
   cgilnosy --> glycosin
   aceegnostu --> gnetaceous
   bbdeeggklooo --> gobbledegook
   aegiot --> goetia
   aeglot --> goleta
   acgiiinott --> goniatitic
   addeeeghnoorsst --> goodheartedness
   deginortu --> gordunite
   degioprss --> gossipred
   fgow --> gowf
   aadginortu --> graduation
   aacghillmnoopry --> nomographically
   aaglnor --> granola
   agghloopry --> graphology
   aegnrtt --> tergant
   agginrz --> grazing
   adeeeglnnrr --> greenlander
   ceeghnrt --> gretchen
   deginrr --> regrind
   egggorry --> groggery
   deegllnnoru --> groundenell
   bgrsu --> grubs
   bgkorsy --> grysbok
   adgoru --> guardo
   egginssu --> guessing
   aaegimnnu --> guineaman
   bdegilnruu --> gunbuilder
   eeginrtuy --> gurneyite
   aaglnorsttuu --> gutturonasal
   aghmnoortxy --> gymnothorax
   gpsy --> gyps
   aafh --> haaf
   achkly --> hackly
   adehiimmooprsu --> haemosporidium
   aahiin --> hainai
   aehly --> healy
   aaehillllm --> halmalille
   aahiiilmmnnost --> hamiltonianism
   adeehmnors --> handersome
   aabghiilnty --> hangability
   acghilloop --> haplologic
   adfhirst --> hardfist
   aaachilmnor --> harmoniacal
   aehirtt --> rathite
   aceehhikltt --> hatchetlike
   adffhorsu --> hausdorff
   adehhnortw --> hawthorned
   adehily --> hylidae
   aeeehhlmnossst --> healthsomeness
   aeehirstw --> heartwise
   aabdehimnor --> hebdomarian
   bdeeeghot --> hedgebote
   eehiin --> heinie
   dehiloor --> heliodor
   beeehillnor --> helleborine
   eehlllpssy --> helplessly
   acehmnoooottyz --> hematocytozoon
   acehiimnop --> hemianopic
   abeeehilmmot --> hemimetabole
   eehmmr --> hemmer
   eehlmooprry --> hemopyrrole
   ehiknr --> henrik
   eehppr --> hepper
   abeeghr --> herbage
   eefhmorr --> herefrom
   dehikmoopr --> hermokopid
   eeghinrrr --> herringer
   abeehlorstty --> heteroblasty
   eeeghinorstt --> heterogenist
   aaeehhioprst --> heterophasia
   eeghoorstuyz --> heterozygous
   abdeeeehhnnorxyz --> hexahydrobenzene
   acehiimnosx --> hexosaminic
   dehiotu --> hideout
   eghhir --> higher
   achiiimrty --> himyaritic
   achiimoppp --> hippocampi
   chiiorsty --> hircosity
   cghiiloost --> histologic
   chiiisttt --> hittitics
   cho --> och
   ghiinost --> hoisting
   acehilnoo --> holocaine
   ahhilnooops --> holosiphona
   adeehmmo --> homemade
   ehhimnosss --> homishness
   aeeghlmnoo --> homogeneal
   ahilmoopss --> homoplasis
   eehiklnoy --> honeylike
   aehkmnoor --> hookerman
   achhlmooops --> hoplomachos
   hinorst --> hornist
   ceehjkoorsy --> horsejockey
   ghinost --> hosting
   efghhiinnorsssuu --> housefurnishings
   afhiimrx --> hrimfaxi
   eghlosuuy --> hugeously
   ceehimtuv --> humective
   ddehnru --> hundred
   ahrruy --> hurray
   htu --> hut
   bdhiry --> hybrid
   adehnoryz --> hydrazone
   acdehinnoorrty --> hydrocotarnine
   acdehmnorry --> hydromancer
   adhhhlmoprstuy --> hydrophthalmus
   acdehhorty --> hydrotheca
   deghikory --> hygrodeik
   ehhllmmnopuyy --> hymenophyllum
   adeehinoprssy --> hyperadenosis
   aabcdehiillopry --> hyperdiabolical
   ceehiiknprty --> hyperkinetic
   aaehiimpprrssty --> hyperparasitism
   acceehhilnprty --> hypertechnical
   ceeghinnopty --> hypnogenetic
   cehnoopy --> hypocone
   ahhlopyy --> hypohyal
   hioppstyy --> hypopitys
   acehhooprttyy --> hypothecatory
   abhhiooppsy --> hypsophobia
   ehmoorsttyy --> hysterotomy
   befinopru --> ibuprofen
   ccghhiilooty --> ichthyologic
   acceiimoss --> icosasemic
   acdegiilllooy --> ideologically
   diiorty --> idiotry
   abgiir --> igbira
   eeiilst --> ilesite
   eiillp --> illipe
   aeillttu --> illutate
   abcdeiimrt --> imbricated
   adeiiimmmst --> immediatism
   acfiiiimmnoortt --> immortification
   aaceimnprt --> impartance
   deeimnnpt --> impendent
   bceeiiilmpprrst --> imperscriptible
   adeilmp --> implead
   aeiimoprrrttu --> importraiture
   eimprss --> persism
   eiimoprsv --> improvise
   aceiilntvy --> inactively
   aabeeiilnnoppprrss --> inappropriableness
   aaaccdeiinptt --> incapacitated
   ccceiimnprstu --> incircumspect
   ceehiinosv --> incohesive
   aabcceeillnno --> inconcealable
   cceiinnnnoty --> incontinency
   acegiinnrs --> increasing
   aabcilnnruu --> incunabular
   deefilnntu --> indefluent
   addeiimn --> indiadem
   cdeiinrt --> reindict
   addeiiintuv --> individuate
   deeimnntu --> induement
   aceiilnst --> sciential
   ceeiillnsuvxy --> inexclusively
   afimny --> manify
   eefiillnrty --> infertilely
   afiiilmnnost --> inflationism
   aafginnrrt --> infragrant
   efiilnsu --> infusile
   aabdgiiilmnnnoou --> inguinoabdominal
   aehiimnnuz --> inhumanize
   eiknt --> inket
   abeiilmnnnos --> innominables
   adiinnorry --> inordinary
   aaiiilnnostv --> insalivation
   aeeilnnssty --> insensately
   abceiilnos --> insociable
   aeillnrst --> installer
   aeilmnnrsttu --> instrumental
   ceiinnorrstu --> insurrection
   aeeeimnprtt --> intemperate
   aaceiiilnnopprtt --> interapplication
   aabceeghilnnrty --> interchangeably
   aceeinnorsttuu --> intercutaneous
   aeefiilmnnorsttu --> interfilamentous
   eiijnorstt --> interjoist
   aaeegiimnrrrt --> intermarriage
   aaeilnnrst --> internasal
   eghiilnprtt --> interplight
   adeinorrt --> interroad
   aeiiilmnnorstttu --> interstimulation
   eeeinnrrtv --> intervener
   adiiimnortty --> intimidatory
   aaaccfiilnrrstu --> intrafascicular
   aceiilnprtv --> intrapelvic
   ggiiinnrtu --> intriguing
   abiiinnostttu --> intubationist
   ceeeiinnsstvv --> invectiveness
   acgiiilnnvy --> invigilancy
   adilnrwy --> inwardly
   eiinorz --> ionizer
   cdeeiirs --> iridesce
   eilnorss --> ironless
   bcdeeiilrru --> irreducible
   beeiiiilprrrssty --> irrepressibility
   abeiilrrt --> irritable
   cdehiiioopst --> ischiopodite
   'inst --> isn't
   acciorsy --> isocracy
   acehiiknnoooprsu --> isokeraunophonic
   aeiilmnoopprsy --> isopropylamine
   aeiloosxz --> isoxazole
   cghiilnty --> itchingly
   cdiiox --> oxidic
   aacijknnos --> jacksonian
   adijlmo --> jaildom
   aajnruy --> january
   aijmmnsu --> jasminum
   acejlor --> jecoral
   adeeijmr --> jeremiad
   ejtty --> jetty
   deegijms --> jimsedge
   ceegjklot --> jockteleg
   eejkmoos --> jokesome
   aejlnou --> joulean
   abiijlotu --> jubilatio
   ceiju --> juice
   aaceegijmnnnorsuu --> jungermanniaceous
   ceiijsstu --> justicies
   adeikn --> kadein
   aaaiklpy --> kalipaya
   aaknss --> kansas
   aaciklmoprsy --> karyoplasmic
   aaikrtu --> katurai
   aaehky --> kehaya
   ehiknst --> kentish
   eekrs --> skere
   eekpru --> keuper
   abhhktu --> khutbah
   aeikllnry --> killarney
   dikns --> kinds
   ikklny --> kinkly
   acdehiknrstw --> kitchenwards
